{
   "texture_atlas": "Assets/Texture-Atlas/mountain_terrain.png",
   "map_width": 17,
   "map_height": 22,
   "MapData": [
      [ 15, 15, 15, 15, 15, 15, 15, 15, 15, 15, 15, 15, 15, 15, 15, 15, 15],
      [ 15, 15, 15, 15, 15, 15, 15, 15, 15, 15, 15, 15, 15, 15, 15, 15, 15],
      [ 15, 15, 15, 15, 15, 15, 15, 15, 15, 15, 15, 15, 15, 15, 15, 15, 15],
      [ 15, 15, 15, 15, 15, 15, 10, 13,  7, 11, 15, 15, 15, 15, 15, 15, 15],
      [ 15, 15, 15, 15, 10,  7,  5, 14, 12,  6,  7,  7, 11, 15, 15, 15, 15],
      [ 15, 15, 15, 10,  5,  0,  5, 12, 12,  6,  0,  0,  6, 11, 15, 15, 15],
      [ 15, 15, 15,  5,  3,  0,  5, 12, 12,  6, 15,  0,  6,  6, 15, 15, 15],
      [ 15, 15, 15,  5,  5,  0,  5, 12, 12,  6, 15,  0,  3,  6, 15, 15, 15],
      [ 15, 15, 15,  5,  5,  0,  8,  2,  2,  9,  1,  1,  6,  6, 15, 15, 15],
      [ 15, 15, 15,  5,  5,  0,  0, 12, 12,  0,  0,  0,  6,  6, 15, 15, 15],
      [ 15, 15, 15,  5,  5,  0,  0, 12, 12,  0,  0,  0,  6,  6, 15, 15, 15],
      [ 15, 15, 15,  5,  5,  0,  1, 12, 12,  0,  0,  0,  6,  6, 15, 15, 15],
      [ 15, 15, 15,  5,  5,  0,  0, 12, 12,  0,  0,  1,  6,  6, 15, 15, 15],
      [ 15, 15, 15,  5,  5,  0,  0, 12, 12,  0,  0,  0,  6,  6, 15, 15, 15],
      [ 15, 15, 15,  5,  8,  4,  4,  2,  2,  4,  4,  4,  9,  6, 15, 15, 15],
      [ 15, 15, 15,  8,  4,  4,  4,  2,  2,  4,  4,  4,  4,  9, 15, 15, 15],
      [ 15, 15, 15, 15, 15, 15, 15, 12, 12, 15, 15, 15, 15, 15, 15, 15, 15],
      [ 15, 15, 15, 15, 15, 15, 15, 12, 12, 15, 15, 15, 15, 15, 15, 15, 15],
      [ 15, 15, 15, 15, 15, 15, 15, 12, 12, 15, 15, 15, 15, 15, 15, 15, 15],
      [ 15, 15, 15, 15, 15, 15, 15, 12, 12, 15, 15, 15, 15, 15, 15, 15, 15],
      [ 15, 15, 15, 15, 15, 15, 15, 12, 12, 15, 15, 15, 15, 15, 15, 15, 15],
      [ 15, 15, 15, 15, 15, 15, 15, 12, 12, 15, 15, 15, 15, 15, 15, 15, 15]
   ],
   "CollisionData": [0, 1, 0, 0, 1, 1, 1, 1, 1, 1, 1, 1, 0, 1, 1, 1],
   "SubareaLocations": [4, 6, 1, 2,
                        12, 7, 8, 2],
   "SubareaSources": ["Map-Data/submap_01.json", "Map-Data/submap_01.json"],
   "north_map_source": "NA",
   "north_x_entrance": 0,
   "west_map_source": "NA",
   "west_y_entrance": 0,
   "east_map_source": "NA",
   "east_y_entrance": 0,
   "south_map_source": "Map-Data/map_05.json",
   "south_x_entrance": 7
}
