{
   "texture_atlas": "Assets/Texture-Atlas/basic_terrain.png",
   "map_width": 12,
   "map_height": 11,
   "MapData": [
      [ 2, 3, 0, 1, 1, 1, 1, 1, 1, 1, 1, 1],
      [ 2, 3, 0, 1, 1, 1, 1, 1, 1, 1, 1, 1],
      [ 2, 3, 3, 3, 1, 1, 1, 1, 1, 1, 1, 1],
      [ 2, 3, 0, 1, 1, 1, 1, 1, 1, 1, 1, 1],
      [ 2, 3, 0, 1, 1, 1, 1, 1, 1, 1, 1, 1],
      [ 2, 3, 0, 1, 1, 1, 1, 1, 1, 1, 1, 1],
      [ 2, 3, 0, 1, 1, 1, 1, 2, 2, 2, 1, 1],
      [ 2, 3, 0, 1, 1, 1, 1, 2, 2, 2, 1, 1],
      [ 2, 3, 0, 1, 1, 1, 1, 2, 2, 2, 1, 1],
      [ 2, 3, 0, 1, 1, 1, 1, 1, 1, 1, 1, 1],
      [ 2, 3, 0, 1, 1, 1, 1, 1, 1, 1, 1, 1]
   ]
}
