{
   "texture_atlas": "Assets/Texture-Atlas/mountain_terrain.png",
   "map_width": 13,
   "map_height": 12,
   "MapData": [
      [15, 15, 15, 15, 15, 15, 15, 15, 15, 15, 15, 15, 15],
      [15, 15, 15, 15, 15, 15, 15, 15, 15, 15, 15, 15, 15],
      [15, 15, 15, 15, 15, 15, 15, 15, 15, 15, 15, 15, 15],
      [15, 15, 15, 15, 15, 15, 15, 15, 15, 15, 15, 15, 15],
      [15, 15, 15, 15,  0,  0,  0,  0, 15, 15, 15, 15, 15],
      [15, 15, 15, 15,  0,  0,  3,  0, 15, 15, 15, 15, 15],
      [15, 15, 15, 15,  0,  0,  0,  0, 15, 15, 15, 15, 15],
      [15, 15, 15, 15,  0,  0,  0,  0, 15, 15, 15, 15, 15],
      [15, 15, 15, 15, 15, 15, 15, 15, 15, 15, 15, 15, 15],
      [15, 15, 15, 15, 15, 15, 15, 15, 15, 15, 15, 15, 15],
      [15, 15, 15, 15, 15, 15, 15, 15, 15, 15, 15, 15, 15],
      [15, 15, 15, 15, 15, 15, 15, 15, 15, 15, 15, 15, 15]
   ],
   "CollisionData": [0, 1, 0, 0, 1, 1, 1, 1, 1, 1, 1, 1, 0, 1, 1, 1],
   "SubareaLocations": [6, 5, 8, 8],
   "SubareaSources": ["Map-Data/submap_01.json"],
   "north_map_source": "NA",
   "north_x_entrance": 0,
   "west_map_source": "NA",
   "west_y_entrance": 0,
   "east_map_source": "NA",
   "east_y_entrance": 0,
   "south_map_source": "NA",
   "south_x_entrance": 0
}
