{
   "texture_atlas": "Assets/Texture-Atlas/basic_terrain.png",
   "map_width": 18,
   "map_height": 16,
   "MapData": [
      [ 2, 2, 2, 2, 2, 2, 2, 1, 1, 1, 1, 3, 3, 1, 1, 1, 1, 1],
      [ 2, 2, 2, 2, 2, 2, 2, 1, 1, 1, 1, 3, 3, 1, 1, 1, 1, 1],
      [ 2, 2, 2, 2, 2, 1, 1, 1, 1, 1, 1, 3, 3, 1, 1, 1, 1, 1],
      [ 1, 1, 1, 1, 1, 1, 1, 1, 1, 1, 1, 3, 3, 1, 1, 1, 1, 1],
      [ 1, 1, 1, 1, 2, 1, 1, 1, 1, 2, 1, 3, 3, 1, 1, 1, 1, 1],
      [ 3, 3, 3, 3, 3, 3, 3, 3, 1, 1, 1, 3, 3, 1, 1, 1, 1, 1],
      [ 3, 3, 3, 3, 3, 3, 3, 3, 3, 3, 3, 3, 3, 1, 1, 1, 1, 1],
      [ 1, 1, 1, 2, 1, 1, 1, 3, 3, 3, 3, 3, 3, 1, 1, 1, 1, 1],
      [ 1, 1, 1, 1, 1, 1, 1, 1, 1, 1, 1, 3, 1, 1, 1, 2, 1, 1],
      [ 1, 1, 3, 3, 1, 1, 1, 2, 1, 1, 1, 3, 3, 1, 1, 1, 1, 1],
      [ 1, 1, 1, 1, 1, 1, 1, 1, 1, 2, 1, 1, 3, 1, 1, 1, 1, 1],
      [ 1, 1, 1, 1, 1, 1, 1, 1, 1, 1, 1, 3, 3, 1, 1, 1, 1, 1],
      [ 2, 2, 2, 2, 2, 2, 2, 2, 2, 2, 2, 3, 3, 2, 2, 2, 2, 1],
      [ 2, 2, 2, 2, 2, 2, 2, 2, 2, 2, 2, 3, 3, 2, 2, 2, 2, 1],
      [ 2, 2, 2, 2, 2, 2, 2, 2, 2, 2, 2, 3, 3, 2, 2, 2, 2, 1],
      [ 2, 2, 2, 2, 2, 2, 2, 2, 2, 2, 2, 3, 3, 2, 2, 2, 2, 1]
   ],
   "CollisionData": [0, 1, 1, 0],
   "north_map_source": "Map-Data/map_01.json",
   "north_x_entrance": 11,
   "west_map_source": "Map-Data/map_04.json",
   "west_y_entrance": 5,
   "east_map_source": "NA",
   "east_y_entrance": 0,
   "south_map_source": "Map-Data/map_02.json",
   "south_x_entrance": 11
}
