{
   "texture_atlas": "Assets/Texture-Atlas/basic_terrain.png",
   "map_width": 17,
   "map_height": 16,
   "MapData": [
      [ 2, 2, 2, 2, 2, 3, 3, 2, 2, 2, 2, 2, 2, 2, 2, 2, 2],
      [ 2, 2, 2, 2, 2, 3, 3, 2, 2, 2, 2, 2, 2, 2, 2, 2, 2],
      [ 2, 2, 2, 2, 2, 3, 3, 2, 2, 2, 2, 2, 2, 2, 2, 2, 2],
      [ 2, 2, 2, 2, 2, 3, 3, 2, 2, 2, 2, 2, 2, 2, 2, 2, 2],
      [ 2, 2, 2, 2, 2, 3, 3, 2, 2, 2, 2, 2, 2, 2, 2, 2, 2],
      [ 2, 2, 2, 2, 2, 3, 3, 0, 1, 1, 1, 1, 1, 1, 1, 1, 1],
      [ 2, 2, 2, 2, 2, 3, 3, 0, 1, 1, 1, 1, 1, 1, 1, 1, 1],
      [ 3, 3, 3, 3, 3, 3, 3, 3, 3, 3, 3, 3, 3, 1, 1, 1, 1],
      [ 0, 0, 0, 0, 0, 0, 3, 0, 1, 1, 1, 1, 3, 1, 1, 1, 1],
      [ 2, 2, 2, 2, 2, 0, 3, 0, 1, 1, 1, 1, 3, 1, 1, 1, 1],
      [ 2, 2, 2, 2, 2, 0, 3, 0, 1, 1, 1, 3, 3, 3, 3, 3, 1],
      [ 2, 2, 2, 2, 2, 0, 3, 0, 1, 1, 1, 3, 2, 2, 2, 3, 1],
      [ 2, 2, 2, 2, 2, 0, 3, 0, 1, 1, 1, 3, 2, 2, 2, 3, 1],
      [ 2, 2, 2, 2, 2, 0, 3, 0, 1, 1, 1, 3, 2, 2, 2, 3, 1],
      [ 2, 2, 2, 2, 2, 0, 3, 0, 1, 1, 1, 3, 3, 3, 3, 3, 1],
      [ 2, 2, 2, 2, 2, 2, 2, 2, 1, 1, 1, 1, 1, 1, 1, 1, 1]
   ],
   "CollisionData": [0, 1, 1, 0],
   "SubareaLocations": [],
   "SubareaSources": ["NA"],
   "north_map_source": "Map-Data/map_05.json",
   "north_x_entrance": 5,
   "west_map_source": "Map-Data/map_03.json",
   "west_y_entrance": 7,
   "east_map_source": "NA",
   "east_y_entrance": 0,
   "south_map_source": "NA",
   "south_x_entrance": 0
}
