{
   "texture_atlas": "Assets/Texture-Atlas/basic_terrain.png",
   "map_width": 16,
   "map_height": 16,
   "MapData": [
      [ 2, 2, 2, 2, 2, 3, 2, 2, 2, 2, 2, 2, 2, 2, 2, 2],
      [ 2, 2, 2, 2, 2, 3, 2, 2, 2, 2, 2, 2, 2, 2, 2, 2],
      [ 2, 2, 2, 2, 2, 3, 2, 2, 2, 2, 2, 2, 2, 2, 2, 2],
      [ 2, 2, 2, 2, 2, 3, 2, 2, 2, 2, 2, 2, 2, 2, 2, 2],
      [ 2, 2, 2, 2, 2, 3, 2, 2, 2, 2, 2, 2, 2, 2, 2, 2],
      [ 2, 2, 2, 2, 2, 3, 0, 1, 1, 1, 1, 1, 1, 1, 1, 1],
      [ 2, 2, 2, 2, 2, 3, 0, 1, 1, 1, 1, 1, 1, 1, 1, 1],
      [ 3, 3, 3, 3, 3, 3, 3, 3, 3, 3, 3, 3, 1, 1, 1, 1],
      [ 0, 0, 0, 0, 0, 3, 0, 1, 1, 1, 1, 3, 1, 1, 1, 1],
      [ 2, 2, 2, 2, 2, 3, 0, 1, 1, 1, 1, 3, 1, 1, 1, 1],
      [ 2, 2, 2, 2, 2, 3, 0, 1, 1, 1, 3, 3, 3, 3, 3, 1],
      [ 2, 2, 2, 2, 2, 3, 0, 1, 1, 1, 3, 2, 2, 2, 3, 1],
      [ 2, 2, 2, 2, 2, 3, 0, 1, 1, 1, 3, 2, 2, 2, 3, 1],
      [ 2, 2, 2, 2, 2, 3, 0, 1, 1, 1, 3, 2, 2, 2, 3, 1],
      [ 2, 2, 2, 2, 2, 3, 0, 1, 1, 1, 3, 3, 3, 3, 3, 1],
      [ 2, 2, 2, 2, 2, 3, 0, 1, 1, 1, 1, 1, 1, 1, 1, 1]
   ],
   "CollisionData": [0, 1, 1, 0]
}
