{
   "texture_atlas": "Assets/Texture-Atlas/basic_terrain.png",
   "map_width": 17,
   "map_height": 16,
   "MapData": [
      [ 2, 2, 2, 2, 2, 2, 2, 2, 2, 2, 2, 2, 2, 2, 2, 2, 2],
      [ 2, 2, 1, 1, 1, 2, 2, 2, 2, 2, 2, 2, 2, 2, 2, 2, 2],
      [ 2, 2, 1, 1, 1, 1, 1, 2, 2, 2, 2, 2, 2, 2, 2, 2, 2],
      [ 2, 2, 1, 1, 1, 1, 1, 1, 1, 1, 1, 1, 1, 1, 1, 1, 1],
      [ 2, 2, 1, 1, 1, 1, 1, 1, 1, 2, 1, 1, 1, 1, 1, 1, 2],
      [ 2, 1, 1, 1, 1, 3, 3, 1, 1, 1, 1, 1, 1, 1, 1, 1, 1],
      [ 2, 1, 1, 1, 1, 3, 3, 3, 3, 3, 3, 3, 3, 3, 3, 3, 3],
      [ 2, 1, 1, 1, 1, 3, 3, 3, 3, 3, 3, 3, 3, 3, 3, 3, 3],
      [ 2, 1, 1, 1, 1, 3, 3, 1, 1, 1, 1, 1, 1, 1, 1, 2, 1],
      [ 2, 1, 1, 2, 1, 3, 3, 1, 1, 1, 1, 1, 1, 1, 1, 1, 1],
      [ 2, 1, 1, 1, 1, 3, 3, 1, 1, 2, 1, 1, 1, 1, 3, 3, 1],
      [ 2, 2, 1, 1, 1, 3, 3, 1, 1, 1, 1, 1, 1, 1, 1, 1, 1],
      [ 2, 2, 2, 2, 2, 3, 3, 2, 2, 2, 2, 2, 2, 2, 2, 2, 2],
      [ 2, 2, 2, 2, 2, 3, 3, 2, 2, 2, 2, 2, 2, 2, 2, 2, 2],
      [ 2, 2, 2, 2, 2, 3, 3, 2, 2, 2, 2, 2, 2, 2, 2, 2, 2],
      [ 2, 2, 2, 2, 2, 3, 3, 2, 2, 2, 2, 2, 2, 2, 2, 2, 2]
   ],
   "CollisionData": [0, 1, 1, 0],
   "north_map_source": "NA",
   "north_x_entrance": 0,
   "west_map_source": "NA",
   "west_y_entrance": 0,
   "east_map_source": "Map-Data/map_05.json",
   "east_y_entrance": 6,
   "south_map_source": "Map-Data/map_03.json",
   "south_x_entrance": 5
}
