{
   "texture_atlas": "Assets/Texture-Atlas/basic_terrain.png",
   "map_width": 21,
   "map_height": 20,
   "MapData": [
      [ 2, 2, 2, 2, 2, 3, 3, 2, 2, 2, 2, 2, 2, 2, 2, 2, 2, 2, 2, 2, 2],
      [ 2, 2, 2, 2, 2, 3, 3, 2, 2, 2, 2, 2, 2, 2, 2, 2, 2, 2, 2, 2, 2],
      [ 2, 2, 2, 2, 2, 3, 3, 2, 2, 2, 2, 2, 2, 2, 2, 2, 2, 2, 2, 2, 2],
      [ 2, 2, 2, 2, 2, 3, 3, 2, 2, 2, 2, 2, 2, 2, 2, 2, 2, 2, 2, 2, 2],
      [ 2, 2, 2, 2, 2, 3, 3, 1, 1, 1, 1, 1, 1, 1, 2, 2, 2, 2, 2, 2, 2],
      [ 2, 2, 2, 2, 2, 3, 3, 1, 1, 1, 1, 1, 1, 3, 0, 0, 2, 2, 2, 2, 2],
      [ 2, 2, 2, 2, 2, 3, 0, 1, 1, 1, 1, 1, 1, 3, 3, 3, 2, 2, 2, 2, 2],
      [ 2, 2, 2, 2, 2, 3, 0, 1, 1, 1, 1, 1, 1, 1, 3, 3, 2, 2, 2, 2, 2],
      [ 2, 2, 2, 2, 2, 3, 0, 1, 1, 1, 1, 1, 1, 1, 3, 3, 2, 2, 2, 2, 2],
      [ 2, 2, 2, 2, 2, 3, 0, 1, 1, 1, 1, 1, 1, 1, 3, 3, 2, 2, 2, 2, 2],
      [ 2, 2, 2, 2, 2, 3, 0, 1, 1, 1, 1, 1, 1, 1, 3, 3, 2, 2, 2, 2, 2],
      [ 2, 2, 2, 2, 2, 3, 3, 3, 3, 3, 3, 3, 3, 3, 3, 3, 3, 3, 3, 3, 3],
      [ 2, 2, 2, 2, 2, 3, 0, 1, 1, 1, 1, 3, 0, 0, 0, 0, 0, 0, 0, 0, 0],
      [ 2, 2, 2, 2, 2, 3, 0, 1, 1, 1, 1, 3, 1, 1, 1, 1, 2, 2, 2, 2, 2],
      [ 2, 2, 2, 2, 2, 3, 0, 1, 1, 1, 3, 3, 3, 3, 3, 1, 2, 2, 2, 2, 2],
      [ 2, 2, 2, 2, 2, 3, 0, 1, 1, 1, 3, 2, 1, 2, 3, 1, 2, 2, 2, 2, 2],
      [ 2, 2, 2, 2, 2, 3, 0, 1, 1, 1, 3, 1, 1, 1, 3, 1, 2, 2, 2, 2, 2],
      [ 2, 2, 2, 2, 2, 3, 0, 1, 1, 1, 3, 2, 1, 2, 3, 1, 2, 2, 2, 2, 2],
      [ 2, 2, 2, 2, 2, 3, 0, 1, 1, 1, 3, 3, 3, 3, 3, 1, 2, 2, 2, 2, 2],
      [ 2, 2, 2, 2, 2, 3, 0, 1, 1, 1, 1, 1, 1, 1, 1, 1, 2, 2, 2, 2, 2]
   ],
   "CollisionData": [0, 1, 1, 0],
   "north_map_source": "Map-Data/map_04.json",
   "north_x_entrance": 5,
   "west_map_source": "NA",
   "west_y_entrance": 0,
   "east_map_source": "Map-Data/map_02.json",
   "east_y_entrance": 11,
   "south_map_source": "NA",
   "south_x_entrance": 0
}
